{
  "id": "dungeon",
  "name": "試練の洞窟",
  "width": 20,
  "height": 20,
  "tileSize": 16,
  "tiles": [
    [2,2,2,2,2,2,2,2,2,2,2,2,2,2,2,2,2,2,2,2],
    [2,2,2,2,2,2,2,2,2,2,2,2,2,2,2,2,2,2,2,2],
    [2,2,0,0,0,0,2,2,2,2,2,2,2,2,2,2,2,2,2,2],
    [2,2,0,0,0,0,2,2,2,2,2,2,2,2,2,2,2,2,2,2],
    [2,2,0,0,0,0,0,0,0,2,2,2,2,2,2,2,2,2,2,2],
    [2,2,2,2,2,2,2,2,0,2,2,2,2,2,2,2,2,2,2,2],
    [2,2,2,2,2,2,2,2,0,2,2,2,2,2,2,2,2,2,2,2],
    [2,2,2,2,2,2,2,2,0,0,0,0,0,2,2,2,2,2,2,2],
    [2,2,2,2,2,2,2,2,2,2,2,2,0,2,2,2,2,2,2,2],
    [2,2,2,2,2,2,2,2,2,2,2,2,0,2,2,2,2,2,2,2],
    [2,2,2,2,2,2,2,2,2,2,2,2,0,2,2,2,2,2,2,2],
    [2,2,2,2,2,2,0,0,0,0,0,0,0,2,2,2,2,2,2,2],
    [2,2,2,2,2,2,0,2,2,2,2,2,2,2,2,2,2,2,2,2],
    [2,2,2,2,2,2,0,2,2,2,2,2,2,2,2,2,2,2,2,2],
    [2,2,2,2,2,2,0,0,0,0,0,0,2,2,2,2,2,2,2,2],
    [2,2,2,2,2,2,2,2,2,2,2,0,2,2,2,2,2,2,2,2],
    [2,2,2,2,2,2,2,2,2,2,2,0,2,2,2,2,2,2,2,2],
    [2,2,2,2,2,2,2,2,2,2,2,0,2,2,2,2,2,2,2,2],
    [2,2,2,2,2,2,2,2,2,2,2,6,2,2,2,2,2,2,2,2],
    [2,2,2,2,2,2,2,2,2,2,2,2,2,2,2,2,2,2,2,2]
  ],
  "spawn": {
    "x": 11,
    "y": 17
  },
  "npcs": [
    {
      "id": "dungeon_guide",
      "sprite": "npc_nurse",
      "x": 4,
      "y": 3,
      "message": "ここは試練の洞窟...\n奥には強敵がいるそうです。"
    }
  ],
  "warps": [
    {
      "id": "warp_to_field",
      "x": 11,
      "y": 18,
      "toMap": "field",
      "toX": 24,
      "toY": 6
    }
  ]
}
